##############
#            #
# ## ### ### #
# ## ### ### #
#            #
##############
